10 10
100 110
0 0 0 0 0 0 0 0 0 0
7 2 2 2 8 0 0 0 0 0
3 1 1 1 2 2 2 2 2 2
3 1 1 1 1 1 1 1 1 1
3 1 1 1 4 2 2 2 2 2
5 2 2 2 6 0 0 0 0 0
0 0 0 0 0 0 0 0 0 0
0 0 0 0 0 0 0 0 0 0
0 0 0 0 0 0 0 0 0 0
0 0 0 0 0 0 0 0 0 0
